..x...x.......................
..x.x.x.xxxxxxxxxxxxxxxxxxxxx.
..x.x.x.x.....................
..x.x.x.x.xxxxxxxxxxxxxxxxxxxx
..x.x.x.x.....................
..x.x.x.xxxxxxxxxxxxxxxxxxxxx.
..x.x...x...x.................
..x.x.xxx.x.x.x...............
..x.x.....x.x.x...............
....x.....x...x..............o